00000S000000000
00000+++++++000
00000000000+000
++++++++++++000
+00000000000000
+00++++++++0000
++++000000+0000
0000000000+0000
00000+++00+0000
00000+0+00+0000
00000+0++++0000
00000+000000000
00000+++++++++E
000000000000000
000000000000000
