S0+++0+++0+++0E
+0+0+0+0+0+0+0+
+0+0+0+0+0+0+0+
+0+0+0+0+0+0+0+
+0+0+0+0+0+0+0+
+0+0+0+0+0+0+0+
+0+0+0+0+0+0+0+
+0+0+0+0+0+0+0+
+0+0+0+0+0+0+0+
+0+0+0+0+0+0+0+
+0+0+0+0+0+0+0+
+0+0+0+0+0+0+0+
+0+0+0+0+0+0+0+
+0+0+0+0+0+0+0+
+++0+++0+++0+++
