S00000000000000
+00000000000000
+00000000000000
+00000000000000
+++++++00000000
000000+00000000
000000+00000000
000000+00000000
000000++++++000
00000000000+000
00000000000+000
00000000000+000
00000000000+000
00000000000+++E
000000000000000
