0S0000000000000
0+00++++++00000
0+00+0000+00000
0++++0000+00000
000000000+00000
000000000+00000
000000000+++++0
0000000000000+0
000+++++++++++0
000+00000000000
000+00000000000
000+++++++++000
00000000000+000
00000000000+000
00000000000E000